12
16
1113111111113111
2000000000000000
2002000000000000
2000000000000000
2000000000000000
2000000110000000
2000000110000000
2000000000000000
2000000000000000
2000000000000000
2000000000000000
1111111111111111
4220